111111111111111111
1                1111
1                1111
1                1111
1                1111
1                1111
1                1111
1                1111
1                1111
1                1111
111111111111111111111111111111111
